30x15
##############################
#P  T  A       #T            #
#  # ### ##### # ########### #
#  #   # #   # # #A          #
#### # # # # # # # ###########
#T     # A # #   # #T        #
# #### # ### # ### # ####### #
# #      #T  #   # #       # #
# # ###### ##### # ####### # #
# A      #     # #   A   # # #
########## ### # ### ### # # #
#T          T# #     #T#   # #
# ########## # ####### ##### #
#            #               S
##############################