15x15
###############
#P  T #   A   #
### # # ### # #
#   # # #T  # #
# ### # ### # #
# #A  #   # # #
# # ### # # # #
# # #T  # #A  #
# # ### # ### #
# #   # #     #
# ### # ##### #
#  T# # #T    #
# # # # # ### #
# A       #  S#
###############